1 2    2 -2    4 -4
2 2    21 -4    21 -2
3 2    2 21    4 21
4 3    1 -1    3 -3    5 -5
5 3    21 -5    21 -3    21 -1
6 3    1 21    3 21    5 21
7 2    -4 4    -2 2
8 2    21 2    21 4
9 2    -4 21    -2 21
10 3    -5 5    -3 3    -1 1
11 3    21 1    21 3    21 5
12 3    -5 21    -3 21    -1 21
13 6    -5 2    -5 4    -3 2    -3 4    -1 2    -1 4
14 6    1 2    1 4    3 2    3 4    5 2    5 4
15 2    2 2    4 4
16 2    -4 2    -2 4
17 2    2 4    4 2
18 1    21 21
19 3    1 1    3 3    5 5
20 6    -4 1    -4 3    -4 5    -2 1    -2 3    -2 5
21 6    2 1    2 3    2 5    4 1    4 3    4 5
22 6    -5 1    -5 3    -3 1    -3 5    -1 3    -1 5
23 6    1 3    1 5    3 1    3 5    5 1    5 3
24 6    -5 -4    -5 -2    -3 -4    -3 -2    -1 -4    -1 -2
25 6    1 -4    1 -2    3 -4    3 -2    5 -4    5 -2
26 2    -4 -4    -2 -2
27 2    -4 -2    -2 -4
28 2    2 -4    4 -2
29 3    -5 -5    -3 -3    -1 -1
30 6    -4 -5    -4 -3    -4 -1    -2 -5    -2 -3    -2 -1
31 6    2 -5    2 -3    2 -1    4 -5    4 -3    4 -1
32 6    -5 -3    -5 -1    -3 -5    -3 -1    -1 -5    -1 -3
33 6    1 -5    1 -3    3 -5    3 -1    5 -3    5 -1
